###########################
E                         # 
#### ######## ## ## ###   #
#  # #  # ### #     # ### #
#  # #### ### ####### #   #
#                ####     #
#####   ##########        #    
#                         # 
##############S############
